###########################################
#@........................................#
#.........................................#
#.........................................#
#.........................................#
#.........................................#
#.........................................#
#.........................................#
#.........................................#
###########################################
